ooooooooooo
o~~~~~~~~~o
o~ooooooo~o
o~o#####o~o
o~o#ooo#o~o
o~o#oxo#o~o
o~o#ooo#o~o
o~o#####o~o
o~ooooooo~o
o~~~~~~~~~o
ooooooooooo
